_ _ _ _ G _ _ X
_ X X X X X _ _
X _ _ _ _ _ _ X
_ _ X X X X _ _
X X _ X _ _ _ _
_ _ S _ _ X _ _
